41 41
1 4 7 2 5 8 0 0 0 0 0 2 5 8 3 6 1 4 7 2 5 8 3 6 1 4 7 2 5 8 3 6 1 4 7 2 5 8 3 6 1
8 0 6 0 0 0 0 0 0 0 0 0 0 0 0 0 0 0 0 0 0 0 0 0 8 0 0 0 0 0 0 0 0 0 6 0 0 0 0 0 8
7 0 5 0 3 0 0 0 0 0 0 0 3 0 0 0 0 0 5 8 3 0 1 0 7 2 5 8 3 0 0 0 0 0 0 8 3 6 1 0 7
6 0 4 0 2 0 0 0 0 0 0 0 2 0 0 0 0 0 4 0 0 0 8 0 0 0 0 0 2 0 0 0 0 0 0 0 0 0 0 0 6
5 0 3 0 1 4 0 0 0 0 0 6 1 0 0 0 0 0 3 0 1 4 7 2 5 8 3 0 1 0 0 0 0 0 0 0 0 0 7 0 5
4 0 2 0 0 0 6 0 0 0 0 0 0 0 0 0 0 0 2 0 0 0 0 0 4 0 2 0 0 0 0 0 0 0 0 0 0 0 6 0 4
3 0 1 4 7 2 5 8 0 0 0 0 0 0 5 0 3 6 1 4 7 2 5 0 3 0 1 4 7 2 0 0 0 0 0 0 0 2 5 0 3
2 0 0 0 0 0 0 0 0 0 0 0 0 0 0 0 2 0 0 0 6 0 0 0 2 0 8 0 0 0 0 0 0 0 0 0 0 0 0 0 2
1 4 7 2 5 8 3 0 0 0 0 0 0 8 3 6 1 0 7 0 5 0 3 6 1 0 7 0 5 8 3 6 1 0 7 2 5 0 3 6 1
8 0 0 0 0 0 0 0 0 0 0 0 0 0 0 0 8 0 6 0 0 0 2 0 0 0 6 0 4 0 0 0 8 0 0 0 0 0 2 0 8
7 0 5 0 3 0 0 0 0 0 0 8 3 6 1 0 7 0 5 8 3 6 1 4 7 0 5 0 3 6 1 0 7 2 5 8 3 6 1 0 7
6 0 4 0 2 0 0 0 0 0 0 0 0 0 0 0 6 0 0 0 0 0 0 0 6 0 0 0 0 0 0 0 0 0 0 0 2 0 0 0 6
5 0 3 0 1 4 0 0 0 0 0 6 1 4 7 2 5 8 0 0 0 0 0 0 5 0 3 0 0 0 0 0 5 8 3 0 1 4 7 0 5
4 0 2 0 0 0 0 0 0 0 0 0 0 0 0 0 0 0 0 0 0 0 0 0 4 0 0 0 0 0 0 0 4 0 0 0 0 0 0 0 4
3 0 1 4 7 2 5 8 3 6 1 0 7 2 5 0 0 0 0 0 0 0 0 0 3 6 1 0 0 0 0 0 3 0 0 0 0 0 5 8 3
2 0 0 0 6 0 4 0 0 0 0 0 6 0 0 0 0 0 0 0 0 0 0 0 2 0 0 0 0 0 0 0 2 0 0 0 0 0 0 0 2
1 4 7 0 5 0 3 0 1 4 7 0 5 0 3 0 0 0 0 0 0 0 0 0 1 0 7 2 5 0 3 0 0 0 0 0 0 0 3 0 1
8 0 0 0 4 0 0 0 0 0 6 0 0 0 0 0 0 0 0 0 0 0 2 0 8 0 6 0 0 0 2 0 0 0 0 0 0 0 2 0 8
0 0 0 0 0 6 1 4 7 2 5 8 3 6 1 4 7 0 5 8 3 0 1 4 7 0 5 0 3 6 1 0 0 0 0 0 3 0 1 0 7
0 0 0 0 0 0 8 0 0 0 0 0 2 0 0 0 0 0 0 0 2 0 0 0 0 0 4 0 0 0 8 0 0 0 0 0 2 0 8 0 6
0 0 0 0 0 0 7 0 5 8 3 0 1 0 7 2 5 8 3 0 1 4 7 2 5 8 3 6 0 0 0 0 0 0 0 0 1 0 7 0 5
0 0 0 0 0 0 0 0 4 0 2 0 8 0 6 0 0 0 2 0 0 0 0 0 0 0 0 0 0 0 0 0 0 0 0 0 8 0 6 0 4
0 0 0 0 0 2 5 8 3 0 1 0 7 2 5 0 3 0 1 4 7 2 5 8 3 0 0 0 0 0 0 0 0 0 1 0 7 2 5 0 3
2 0 0 0 6 0 0 0 0 0 8 0 0 0 0 0 2 0 0 0 6 0 0 0 0 0 0 0 0 0 0 0 0 0 8 0 0 0 0 0 0
1 0 7 0 5 8 3 0 1 4 7 2 5 8 3 6 1 4 7 0 5 8 3 0 1 0 0 0 0 0 0 0 0 4 7 2 0 0 0 0 0
8 0 6 0 0 0 0 0 8 0 0 0 0 0 0 0 8 0 6 0 0 0 2 0 8 0 0 0 0 0 0 0 0 0 6 0 0 0 0 0 0
7 0 5 8 3 6 1 4 7 0 5 0 3 6 1 0 7 0 5 8 3 0 1 0 7 0 0 0 0 0 0 0 0 0 5 0 0 0 0 0 0
6 0 0 0 0 0 8 0 0 0 4 0 2 0 0 0 0 0 4 0 0 0 8 0 6 0 0 0 0 0 0 0 0 0 4 0 0 0 0 0 0
5 0 3 6 1 0 7 0 5 8 3 0 1 4 7 2 5 8 3 0 1 4 7 2 5 0 3 6 0 0 0 0 0 0 0 0 1 4 7 0 5
4 0 2 0 8 0 0 0 4 0 0 0 8 0 0 0 0 0 0 0 8 0 0 0 4 0 2 0 0 0 0 0 0 0 0 0 0 0 0 0 4
3 0 1 0 7 2 5 8 3 0 1 0 7 0 5 8 3 6 1 4 7 0 5 0 3 0 1 0 7 2 0 0 0 0 0 0 7 2 5 0 3
2 0 0 0 6 0 0 0 0 0 8 0 6 0 4 0 0 0 0 0 0 0 4 0 0 0 8 0 0 0 0 0 0 0 0 0 0 0 4 0 2
1 4 7 0 5 0 3 6 1 4 7 2 5 0 3 0 1 4 7 2 5 8 3 6 1 4 7 0 5 0 0 0 0 0 0 0 5 8 3 0 1
8 0 6 0 4 0 2 0 0 0 0 0 0 0 2 0 0 0 6 0 0 0 2 0 8 0 0 0 4 0 0 0 0 0 0 0 0 0 0 0 8
7 0 5 0 3 0 1 0 7 2 5 8 3 6 1 4 7 0 5 0 3 0 1 0 7 0 5 8 3 6 1 4 7 2 5 8 3 6 1 4 7
6 0 0 0 2 0 8 0 0 0 0 0 0 0 0 0 6 0 0 0 2 0 8 0 6 0 4 0 0 0 0 0 0 0 0 0 0 0 0 0 6
5 0 3 6 1 0 7 2 5 8 3 6 1 4 7 0 5 8 3 6 1 0 7 0 5 0 3 6 1 4 7 2 5 0 3 6 1 4 7 0 5
4 0 2 0 8 0 0 0 4 0 0 0 0 0 6 0 0 0 0 0 0 0 6 0 4 0 0 0 0 0 0 0 0 0 2 0 0 0 6 0 4
3 0 1 0 7 2 5 0 3 0 1 4 7 0 5 8 3 6 1 4 7 2 5 0 3 6 1 4 7 2 5 8 3 6 1 0 7 2 5 0 3
2 0 0 0 0 0 4 0 0 0 0 0 6 0 0 0 0 0 0 0 0 0 0 0 0 0 0 0 0 0 0 0 0 0 0 0 0 0 0 0 2
1 4 7 2 5 8 3 6 1 4 7 2 5 8 3 6 1 4 7 2 5 8 3 6 1 4 7 2 5 8 3 6 1 4 7 2 5 8 3 6 1
6.5 0.5 0.0
39.5 39.5
12
1.5 18.5 0
32.5 2.5 0
24.5 39.5 0
3.5 31.5 0
13.5 19.5 1
25.5 39.5 1
34.5 33.5 1
32.5 31.5 1
33.5 30.5 2
10.5 39.5 2
5.5 35.5 2
7.5 11.5 2
