51 51
2 5 8 3 6 1 4 7 2 5 8 3 6 1 4 7 2 5 8 3 6 1 4 7 2 5 8 3 6 1 0 0 0 0 0 3 6 0 0 0 0 0 8 3 6 1 4 7 2 5 8
1 0 7 0 5 0 0 0 0 0 0 0 0 0 3 0 0 0 0 0 0 0 3 0 0 0 0 0 0 0 0 0 0 0 0 0 0 0 0 0 0 0 7 0 0 0 0 0 0 0 7
8 0 6 0 4 0 2 5 8 3 6 0 4 0 2 5 0 0 0 0 0 0 2 0 8 3 6 1 4 0 0 0 0 0 0 1 4 0 0 0 0 0 6 1 4 0 2 5 8 0 6
7 0 5 0 0 0 0 0 0 0 5 0 3 0 1 0 0 0 0 0 0 0 0 0 0 0 0 0 3 0 0 0 0 0 0 0 0 0 0 0 0 0 0 0 3 0 0 0 7 0 5
6 0 0 0 0 0 8 3 6 0 4 0 2 0 8 0 0 0 0 0 0 5 8 3 6 1 4 7 2 0 0 0 0 0 0 0 2 0 0 0 0 0 4 0 2 5 8 3 6 0 4
5 0 0 0 0 0 7 0 0 0 3 0 1 0 0 0 0 0 0 0 0 0 0 0 0 0 3 0 0 0 0 0 0 0 0 0 1 0 0 0 5 0 0 0 1 0 0 0 5 0 3
4 0 0 0 0 0 6 1 4 0 2 0 8 3 6 1 4 0 2 5 8 0 6 0 0 0 0 0 8 0 0 0 0 0 2 5 8 0 6 0 4 7 2 0 8 0 6 0 4 0 2
3 0 0 0 0 0 0 0 3 0 1 0 0 0 5 0 3 0 1 0 0 0 0 0 0 0 0 0 7 0 0 0 0 0 0 0 7 0 5 0 0 0 1 0 7 0 5 0 0 0 1
2 0 0 0 0 0 4 0 2 5 8 3 6 0 4 0 2 0 8 3 6 1 4 0 0 0 0 0 6 0 4 7 2 5 8 0 6 1 4 7 2 0 8 0 6 0 4 7 2 0 8
1 0 7 0 0 0 3 0 1 0 0 0 5 0 3 0 0 0 0 0 0 0 0 0 0 0 0 0 5 0 0 0 1 0 0 0 5 0 0 0 1 0 7 0 0 0 3 0 1 0 7
8 0 6 0 4 0 2 0 8 0 6 0 4 0 2 0 8 3 6 1 4 7 2 0 0 0 0 0 4 0 2 5 8 0 6 1 4 0 2 0 8 0 6 1 4 7 2 0 8 0 6
7 0 0 0 3 0 1 0 0 0 0 0 0 0 0 0 7 0 0 0 3 0 0 0 0 0 5 0 0 0 1 0 0 0 5 0 0 0 1 0 0 0 5 0 3 0 0 0 7 0 5
6 0 4 7 2 0 8 3 6 1 0 0 0 0 0 3 6 0 0 0 0 0 0 0 6 1 4 7 2 5 8 0 6 1 4 7 2 0 8 3 6 1 4 0 2 0 8 0 6 0 4
5 0 0 0 1 0 0 0 5 0 0 0 0 0 0 0 0 0 0 0 0 0 0 0 0 0 0 0 0 0 7 0 5 0 0 0 0 0 7 0 0 0 0 0 1 0 7 0 0 0 3
4 0 2 5 8 0 6 1 4 0 0 0 0 0 0 1 4 7 0 0 0 0 0 0 4 7 2 5 8 0 6 0 4 7 2 0 8 3 6 1 4 0 2 0 8 0 6 1 4 7 2
3 0 1 0 0 0 5 0 0 0 0 0 0 0 0 0 3 0 0 0 0 0 0 0 0 0 1 0 0 0 5 0 0 0 0 0 7 0 0 0 0 0 1 0 7 0 5 0 0 0 1
2 0 8 0 6 1 4 0 2 5 0 0 0 0 0 0 2 0 0 0 0 0 0 7 2 0 8 0 6 1 4 7 2 5 8 3 6 0 4 0 2 5 8 0 6 0 4 0 2 0 8
1 0 7 0 0 0 0 0 1 0 0 0 0 0 0 0 1 0 0 0 0 0 0 0 1 0 7 0 0 0 0 0 0 0 0 0 5 0 3 0 1 0 0 0 5 0 3 0 1 0 7
8 0 6 1 4 7 2 5 8 0 6 1 4 0 0 0 0 0 0 0 0 0 2 0 8 3 6 1 4 0 2 5 8 3 6 1 4 0 2 0 8 3 0 0 0 0 0 0 8 0 6
7 0 5 0 0 0 1 0 0 0 5 0 3 0 0 0 0 0 0 0 0 0 1 0 0 0 0 0 3 0 0 0 0 0 0 0 3 0 1 0 0 0 0 0 0 0 0 0 7 0 5
6 0 4 7 2 0 8 0 6 1 4 0 2 0 0 0 0 0 0 0 0 0 0 3 6 1 4 0 2 5 8 0 6 1 4 0 2 0 8 3 6 1 0 0 0 0 0 0 6 0 4
5 0 0 0 1 0 0 0 0 0 0 0 0 0 0 0 0 0 0 0 0 0 0 0 0 0 3 0 0 0 7 0 5 0 3 0 0 0 0 0 5 0 0 0 0 0 0 0 5 0 3
4 7 2 0 0 0 0 0 0 7 2 5 8 0 0 0 0 0 0 0 0 0 0 1 4 0 2 5 8 0 6 0 4 0 2 5 8 3 6 1 4 0 0 0 0 0 0 1 4 7 2
3 0 1 0 0 0 0 0 0 0 1 0 0 0 0 0 0 0 0 0 0 0 0 0 0 0 0 0 7 0 5 0 0 0 0 0 0 0 5 0 0 0 1 0 0 0 5 0 0 0 1
2 0 8 3 0 0 0 0 0 0 8 3 6 1 4 0 0 0 0 0 0 0 0 0 0 0 0 0 6 0 4 7 2 5 8 3 6 0 4 0 2 5 8 3 6 0 4 0 2 0 8
1 0 0 0 0 0 0 0 0 0 7 0 0 0 3 0 0 0 0 0 0 0 0 0 0 0 0 0 0 0 0 0 1 0 7 0 0 0 3 0 0 0 0 0 5 0 0 0 1 0 7
8 0 6 0 0 0 0 0 0 0 6 0 4 0 2 5 0 0 0 0 0 7 2 0 0 0 0 0 0 0 0 0 8 0 6 0 4 7 2 5 8 3 6 0 4 7 2 5 8 0 6
7 0 5 0 0 0 1 0 7 0 0 0 3 0 0 0 0 0 0 0 0 0 0 0 0 0 0 0 0 0 0 0 7 0 5 0 0 0 0 0 0 0 0 0 0 0 1 0 0 0 5
6 0 4 7 2 5 8 3 6 1 4 7 2 5 8 0 6 1 4 7 2 5 8 0 0 0 0 0 0 0 0 0 6 0 4 7 2 0 8 3 0 0 0 0 0 0 8 0 6 1 4
5 0 0 0 0 0 0 0 0 0 0 0 0 0 7 0 0 0 0 0 0 0 0 0 5 0 0 0 0 0 0 0 5 0 0 0 0 0 7 0 0 0 0 0 0 0 0 0 0 0 3
4 7 2 5 8 3 6 1 4 0 2 5 8 0 6 1 4 7 2 5 8 3 6 0 4 7 2 0 8 0 0 0 0 0 2 5 8 3 6 0 0 0 0 0 0 0 0 0 4 0 2
3 0 0 0 0 0 0 0 3 0 1 0 0 0 5 0 3 0 0 0 0 0 5 0 0 0 1 0 7 0 0 0 0 0 0 0 0 0 0 0 0 0 0 0 0 0 0 0 0 0 1
2 0 0 0 0 0 4 0 2 5 8 0 6 0 4 0 2 0 8 0 6 0 4 7 2 0 8 3 6 0 0 0 0 0 8 3 6 1 4 7 2 5 8 0 0 0 0 0 2 0 8
1 0 0 0 0 0 3 0 0 0 0 0 5 0 3 0 1 0 7 0 5 0 3 0 1 0 0 0 5 0 0 0 0 0 0 0 5 0 0 0 0 0 0 0 0 0 0 0 0 0 7
8 0 0 0 0 0 2 5 8 3 6 1 4 0 2 0 8 0 6 0 4 0 2 0 8 3 6 0 4 0 0 0 0 0 6 0 4 0 2 5 8 3 6 1 4 7 2 5 8 0 6
7 0 0 0 0 0 1 0 0 0 0 0 3 0 1 0 0 0 5 0 3 0 0 0 7 0 5 0 3 0 0 0 7 0 5 0 3 0 0 0 0 0 0 0 0 0 0 0 7 0 5
6 0 0 0 0 0 8 0 6 0 4 0 2 0 8 3 6 1 4 0 2 5 8 0 6 0 4 0 2 0 8 3 6 0 4 7 2 5 8 0 6 1 4 7 0 0 0 0 0 1 4
5 0 3 0 1 0 7 0 5 0 3 0 1 0 7 0 0 0 0 0 1 0 7 0 5 0 3 0 1 0 0 0 0 0 3 0 0 0 0 0 5 0 0 0 0 0 0 0 0 0 3
4 0 2 0 8 0 6 0 4 0 2 5 8 0 6 0 4 7 2 5 8 0 6 0 4 0 2 0 8 3 6 0 4 7 2 0 0 0 0 0 4 0 2 0 0 0 0 0 0 0 2
3 0 1 0 7 0 0 0 3 0 0 0 0 0 5 0 3 0 0 0 0 0 0 0 0 0 1 0 7 0 0 0 3 0 0 0 0 0 0 0 3 0 1 0 0 0 0 0 0 0 1
2 0 8 0 6 1 4 7 2 0 0 0 0 0 4 0 2 5 8 3 6 1 4 7 2 5 8 0 6 1 4 7 2 0 8 0 0 0 0 0 0 0 0 0 0 0 0 0 0 0 8
1 0 7 0 0 0 0 0 1 0 0 0 0 0 3 0 0 0 7 0 0 0 0 0 1 0 0 0 5 0 0 0 0 0 7 0 0 0 0 0 0 0 0 0 0 0 0 0 1 0 7
8 0 6 1 4 7 2 0 8 0 0 0 0 0 2 0 8 0 6 0 4 7 2 0 8 0 6 1 4 0 2 5 8 3 6 0 4 7 0 0 0 0 0 0 0 0 0 0 8 0 6
7 0 5 0 0 0 0 0 0 0 0 0 0 0 0 0 7 0 5 0 0 0 0 0 7 0 0 0 3 0 1 0 0 0 5 0 3 0 0 0 0 0 0 0 0 0 0 0 7 0 5
6 0 4 0 0 0 0 0 0 0 4 7 2 5 8 3 6 0 4 0 0 0 0 0 6 1 4 0 2 0 8 0 6 0 4 0 2 5 0 0 0 0 0 0 2 5 8 3 6 0 4
5 0 3 0 0 0 0 0 0 0 0 0 0 0 7 0 0 0 3 0 0 0 0 0 0 0 3 0 1 0 7 0 5 0 3 0 1 0 0 0 5 0 0 0 1 0 0 0 0 0 3
4 0 2 0 0 0 0 0 0 0 0 5 8 0 6 0 4 0 2 0 0 0 0 0 4 0 2 0 8 0 6 0 4 7 2 0 8 0 6 1 4 0 2 5 8 3 6 1 4 0 2
3 0 1 0 0 0 0 0 0 0 0 0 0 0 0 0 3 0 1 0 0 0 0 0 3 0 1 0 7 0 5 0 0 0 0 0 7 0 5 0 3 0 1 0 0 0 0 0 3 0 1
2 0 8 0 0 0 0 0 0 0 0 3 6 1 4 7 2 5 8 3 6 0 4 0 2 5 8 0 6 0 4 0 2 5 8 3 6 0 4 0 2 0 8 3 6 0 4 0 2 0 8
1 0 0 0 0 0 0 0 0 0 0 0 0 0 0 0 0 0 0 0 0 0 3 0 0 0 0 0 0 0 3 0 0 0 0 0 0 0 3 0 0 0 0 0 0 0 3 0 0 0 7
8 3 6 1 4 0 0 0 0 0 6 1 4 7 2 5 8 3 6 1 4 7 2 5 8 3 6 1 4 7 2 5 8 3 6 1 4 7 2 5 8 3 6 1 4 7 2 5 8 3 6
30.5 0.5 0.0
9.5 50.5
18
48.5 38.5 0
1.5 2.5 0
7.5 24.5 0
45.5 3.5 0
46.5 5.5 0
1.5 43.5 1
37.5 39.5 1
17.5 39.5 1
23.5 3.5 1
36.5 37.5 1
8.5 49.5 2
4.5 46.5 2
23.5 41.5 2
36.5 11.5 2
4.5 41.5 2
11.5 4.5 3
19.5 17.5 3
32.5 30.5 3
