61 41
3 6 1 4 7 2 5 8 3 6 1 4 7 2 5 8 3 6 1 4 7 2 5 8 3 6 1 4 7 2 5 8 3 6 1 4 7 2 5 8 3 6 1 4 7 2 5 8 3 6 1 4 7 2 5 8 3 6 1 4 7
2 0 0 0 6 0 0 0 0 0 0 0 6 0 4 0 0 0 0 0 6 0 0 0 0 0 0 0 0 0 4 0 0 0 0 0 6 0 0 0 0 0 0 0 0 0 0 0 0 0 0 0 0 0 0 0 2 0 0 0 6
1 4 7 0 5 8 3 0 1 4 7 0 5 0 3 0 1 0 7 2 5 0 3 6 1 0 7 2 5 0 3 0 1 4 7 0 5 0 0 0 0 0 7 2 5 0 3 6 1 4 7 2 5 8 3 0 1 4 7 0 5
8 0 6 0 0 0 0 0 8 0 6 0 4 0 2 0 8 0 0 0 0 0 0 0 8 0 0 0 4 0 2 0 8 0 0 0 0 0 0 0 0 0 0 0 4 0 0 0 8 0 0 0 0 0 2 0 8 0 0 0 4
7 0 5 8 3 6 1 4 7 0 5 0 3 0 1 0 7 2 5 8 3 6 1 4 7 2 5 0 3 0 0 0 0 0 0 8 3 0 0 0 0 0 5 0 3 6 1 0 7 0 5 8 3 0 1 0 7 0 5 0 3
6 0 0 0 0 0 0 0 0 0 4 0 2 0 0 0 0 0 4 0 0 0 0 0 0 0 0 0 2 0 0 0 0 0 0 0 0 0 0 0 0 0 0 0 2 0 8 0 6 0 0 0 2 0 8 0 0 0 4 0 2
5 0 3 0 1 4 7 2 5 0 3 0 1 4 7 2 5 8 3 0 0 0 0 0 5 8 3 6 1 0 0 0 0 0 0 0 0 0 0 0 0 0 3 6 1 0 7 0 5 0 3 0 1 4 7 2 5 8 3 0 1
4 0 2 0 8 0 0 0 4 0 2 0 0 0 0 0 0 0 2 0 0 0 0 0 0 0 0 0 8 0 0 0 0 0 0 0 0 0 0 0 0 0 0 0 0 0 6 0 4 0 2 0 0 0 0 0 4 0 0 0 8
3 0 1 0 7 0 5 0 3 6 1 4 7 2 5 8 3 0 1 0 0 0 0 0 3 6 1 0 7 2 0 0 0 0 0 0 0 0 0 0 0 0 1 0 7 0 5 0 3 6 1 4 7 2 5 0 3 0 1 4 7
2 0 8 0 0 0 4 0 0 0 0 0 6 0 0 0 0 0 8 0 0 0 0 0 0 0 8 0 0 0 4 0 0 0 0 0 0 0 0 0 0 0 0 0 0 0 0 0 0 0 0 0 0 0 0 0 2 0 0 0 6
1 0 7 2 5 8 3 6 1 0 7 2 5 0 3 6 1 4 7 0 0 0 0 0 1 0 7 0 0 0 0 0 1 0 7 2 5 0 0 0 0 0 7 2 0 0 0 0 0 0 7 2 5 8 3 6 1 4 7 0 5
8 0 0 0 4 0 0 0 8 0 0 0 0 0 2 0 0 0 0 0 4 0 0 0 8 0 6 0 0 0 0 0 8 0 0 0 0 0 2 0 8 0 0 0 0 0 0 0 0 0 6 0 0 0 0 0 8 0 0 0 4
7 2 5 0 3 0 1 0 7 2 5 8 3 6 1 0 7 2 5 8 3 0 1 0 7 0 5 0 0 0 0 0 7 2 5 8 3 6 1 0 7 0 0 0 0 0 0 0 0 0 5 0 3 6 1 0 7 0 5 8 3
6 0 4 0 0 0 8 0 0 0 0 0 0 0 0 0 6 0 0 0 0 0 8 0 0 0 4 0 0 0 0 0 0 0 0 0 0 0 8 0 0 0 0 0 0 0 0 0 0 0 4 0 0 0 8 0 0 0 4 0 2
5 0 3 6 1 4 7 2 5 8 0 0 0 0 0 2 5 0 3 6 1 0 7 0 5 8 3 0 0 0 0 0 5 0 0 0 0 0 7 2 5 0 0 0 0 0 7 0 5 0 3 6 1 0 7 2 5 8 3 0 1
4 0 0 0 0 0 0 0 0 0 0 0 0 0 0 0 0 0 2 0 0 0 6 0 4 0 0 0 0 0 0 0 0 0 0 0 0 0 0 0 0 0 0 0 0 0 6 0 4 0 2 0 0 0 6 0 0 0 0 0 8
3 0 1 4 7 2 5 8 3 6 0 0 0 0 0 8 3 6 1 0 7 2 5 0 3 0 1 4 7 0 5 8 3 0 0 0 0 0 0 8 3 6 1 4 7 0 5 0 3 0 1 0 7 2 5 8 3 0 1 0 7
2 0 0 0 0 0 0 0 0 0 0 0 0 0 0 0 0 0 8 0 6 0 0 0 2 0 0 0 6 0 0 0 0 0 0 0 0 0 0 0 2 0 0 0 0 0 4 0 2 0 8 0 0 0 0 0 0 0 0 0 0
1 0 7 2 0 0 0 0 0 4 0 0 0 0 0 6 1 0 7 0 5 0 3 6 1 4 7 0 5 0 0 0 0 0 0 0 0 0 0 6 1 0 7 2 5 8 3 0 1 0 7 2 5 8 3 6 0 0 0 0 0
8 0 0 0 0 0 0 0 0 0 0 0 4 0 0 0 0 0 0 0 0 0 0 0 0 0 6 0 4 0 0 0 0 0 0 0 0 0 0 0 0 0 6 0 0 0 0 0 8 0 0 0 0 0 0 0 0 0 0 0 0
7 2 5 8 0 0 0 0 0 0 5 8 3 6 1 4 7 0 0 0 0 0 1 0 7 2 5 0 3 6 0 0 0 0 0 8 3 6 1 4 7 2 5 8 3 6 1 0 7 2 5 0 3 6 1 0 0 0 0 0 0
6 0 0 0 0 0 0 0 0 0 0 0 2 0 0 0 0 0 0 0 0 0 8 0 6 0 0 0 2 0 0 0 0 0 0 0 0 0 0 0 0 0 0 0 0 0 8 0 0 0 4 0 0 0 8 0 0 0 0 0 0
5 0 3 6 0 0 0 0 0 8 3 0 1 0 7 2 5 0 0 0 0 0 7 0 5 0 3 6 1 4 7 0 5 8 3 0 1 0 7 2 5 8 3 6 1 0 7 0 5 0 3 6 1 0 7 0 5 0 3 0 1
4 0 0 0 0 0 0 0 0 0 0 0 0 0 0 0 0 0 0 0 0 0 0 0 4 0 2 0 0 0 0 0 4 0 0 0 8 0 6 0 0 0 0 0 8 0 6 0 4 0 0 0 8 0 6 0 0 0 0 0 8
3 6 1 0 0 0 0 0 0 0 1 4 0 0 0 0 0 0 1 0 7 2 5 8 3 0 1 0 7 0 5 8 3 0 1 4 7 0 5 8 3 0 1 0 7 0 5 0 3 6 1 0 7 2 5 8 3 6 1 0 7
2 0 0 0 0 0 0 0 0 0 0 0 0 0 0 0 0 0 8 0 6 0 0 0 0 0 8 0 6 0 0 0 0 0 0 0 6 0 0 0 2 0 8 0 6 0 4 0 0 0 8 0 0 0 0 0 2 0 8 0 6
1 0 7 2 0 0 0 0 0 0 0 0 0 0 0 0 0 0 7 2 5 0 3 6 1 4 7 2 5 8 3 0 1 4 7 2 5 8 3 0 0 0 0 0 5 0 3 6 1 4 7 2 5 0 3 0 1 0 7 0 5
8 0 6 0 0 0 0 0 0 0 0 0 0 0 0 0 0 0 6 0 0 0 2 0 0 0 0 0 0 0 2 0 8 0 0 0 0 0 2 0 0 0 0 0 4 0 2 0 0 0 0 0 4 0 2 0 8 0 0 0 4
7 0 5 8 3 0 0 0 0 0 0 0 0 0 1 0 7 0 5 0 3 6 1 4 7 0 5 8 3 0 1 4 7 0 5 8 3 0 1 0 0 0 0 0 3 0 1 0 7 2 5 0 3 6 1 0 7 0 5 8 3
6 0 0 0 0 0 0 0 0 0 0 0 0 0 8 0 6 0 0 0 0 0 0 0 0 0 4 0 2 0 0 0 6 0 0 0 2 0 0 0 0 0 0 0 2 0 0 0 6 0 4 0 0 0 0 0 6 0 0 0 2
5 8 3 6 1 0 0 0 0 0 3 0 1 0 7 0 5 8 3 0 0 0 0 0 5 8 3 0 1 4 7 0 5 8 3 0 1 4 7 0 0 0 0 0 1 4 7 2 5 0 3 6 1 4 7 2 5 8 3 0 1
4 0 0 0 8 0 0 0 0 0 0 0 8 0 0 0 0 0 0 0 0 0 0 0 0 0 0 0 0 0 6 0 0 0 2 0 0 0 6 0 4 0 0 0 0 0 0 0 0 0 2 0 0 0 0 0 0 0 0 0 8
3 0 1 4 7 0 0 0 0 0 1 4 7 2 5 0 0 0 0 0 0 0 0 0 0 0 0 4 7 2 5 8 3 0 1 0 7 0 5 0 3 0 1 4 7 0 5 8 3 0 1 0 7 2 5 0 0 0 0 0 7
2 0 0 0 6 0 0 0 2 0 8 0 0 0 0 0 0 0 0 0 0 0 0 0 0 0 0 0 0 0 4 0 0 0 0 0 0 0 0 0 2 0 0 0 6 0 0 0 2 0 8 0 6 0 0 0 0 0 0 0 6
1 4 7 0 5 8 3 0 1 0 7 2 5 8 3 0 0 0 0 0 5 0 0 0 0 0 0 0 5 0 3 0 0 0 0 0 0 0 0 0 0 0 0 0 5 8 0 0 0 0 0 0 5 0 3 0 0 0 0 0 5
8 0 0 0 4 0 2 0 8 0 0 0 0 0 0 0 0 0 0 0 4 0 0 0 0 0 0 0 4 0 0 0 0 0 0 0 0 0 0 0 0 0 0 0 4 0 0 0 0 0 0 0 0 0 0 0 0 0 0 0 4
7 0 5 0 3 0 1 0 7 2 5 8 3 6 1 0 7 2 5 0 3 6 0 0 0 0 0 8 3 6 1 4 0 0 0 0 0 0 0 0 0 0 0 0 3 0 0 0 0 0 0 0 0 6 1 4 7 0 5 0 3
6 0 4 0 0 0 8 0 6 0 0 0 0 0 8 0 0 0 4 0 2 0 0 0 0 0 0 0 2 0 0 0 0 0 0 0 0 0 0 0 0 0 0 0 2 0 0 0 0 0 0 0 0 0 0 0 6 0 4 0 2
5 0 3 6 1 4 7 0 5 0 3 6 1 0 7 2 5 0 3 0 1 0 0 0 0 0 0 0 1 0 7 0 0 0 0 0 0 0 0 0 0 0 0 0 1 4 0 0 0 0 0 0 0 0 7 0 5 8 3 0 1
4 0 0 0 0 0 0 0 0 0 2 0 0 0 0 0 0 0 2 0 0 0 0 0 0 0 0 0 0 0 6 0 0 0 0 0 0 0 0 0 0 0 0 0 0 0 6 0 0 0 0 0 0 0 6 0 0 0 0 0 8
3 6 1 4 7 2 5 8 3 6 1 4 7 2 5 8 3 6 1 4 7 2 5 8 3 6 1 4 7 2 5 8 3 6 0 0 0 0 0 8 3 6 1 4 7 2 5 8 3 6 1 4 7 2 5 8 3 6 1 4 7
1.5 1.5 0.0
38.5 40.5
24
20.5 39.5 0
13.5 1.5 0
57.5 27.5 0
37.5 18.5 0
16.5 35.5 0
33.5 31.5 0
33.5 7.5 1
2.5 15.5 1
19.5 17.5 1
20.5 33.5 1
17.5 1.5 1
31.5 7.5 1
38.5 15.5 2
45.5 28.5 2
53.5 17.5 2
30.5 5.5 2
9.5 4.5 2
30.5 19.5 2
33.5 20.5 3
5.5 20.5 3
38.5 2.5 3
16.5 26.5 3
48.5 1.5 3
47.5 10.5 3
