71 51
5 8 3 6 1 4 7 2 5 8 3 6 1 4 7 2 5 8 3 6 1 4 7 2 5 8 3 6 1 4 7 2 5 8 3 6 1 4 7 2 5 8 3 6 1 4 7 2 5 8 3 0 0 0 0 0 5 8 3 6 1 4 7 2 5 8 3 6 1 4 7
4 0 0 0 0 0 6 0 0 0 2 0 0 0 0 0 0 0 2 0 0 0 6 0 0 0 0 0 0 0 0 0 0 0 0 0 0 0 0 0 4 0 0 0 0 0 6 0 0 0 0 0 0 0 0 0 0 0 0 0 8 0 0 0 4 0 0 0 0 0 6
3 6 1 4 7 0 5 0 3 0 1 0 7 2 5 8 3 0 0 0 0 0 0 0 3 6 1 4 7 2 5 8 3 6 0 0 0 0 0 8 3 0 1 0 7 2 5 0 3 6 1 0 0 0 0 0 3 0 1 0 7 0 5 0 3 0 1 0 7 0 5
2 0 0 0 6 0 0 0 2 0 8 0 6 0 0 0 2 0 0 0 0 0 0 0 0 0 0 0 0 0 0 0 0 0 0 0 0 0 0 0 0 0 8 0 0 0 0 0 2 0 0 0 0 0 0 0 0 0 8 0 0 0 4 0 2 0 8 0 6 0 4
1 0 7 2 5 8 3 6 1 0 7 0 5 0 3 0 1 4 0 0 0 0 0 6 1 4 7 2 5 8 3 6 1 0 0 0 0 0 0 0 1 4 7 2 5 8 3 6 1 0 7 0 0 0 0 0 0 4 7 2 5 8 3 0 1 4 7 0 5 0 3
8 0 0 0 0 0 2 0 0 0 6 0 0 0 2 0 0 0 0 0 0 0 0 0 0 0 0 0 0 0 2 0 0 0 0 0 0 0 0 0 0 0 0 0 4 0 2 0 0 0 6 0 0 0 0 0 0 0 0 0 0 0 0 0 0 0 6 0 4 0 2
7 2 5 0 3 0 1 0 7 2 5 0 3 6 1 4 7 2 0 0 0 0 0 0 0 0 5 8 3 6 1 0 7 2 0 0 0 0 0 4 7 2 5 0 3 0 0 0 0 0 5 0 0 0 0 0 0 0 5 0 0 0 0 0 7 0 5 0 3 0 1
6 0 0 0 2 0 8 0 0 0 4 0 2 0 0 0 0 0 4 0 0 0 0 0 0 0 0 0 0 0 8 0 0 0 4 0 2 0 0 0 0 0 0 0 2 0 0 0 0 0 0 0 0 0 0 0 0 0 4 0 0 0 0 0 6 0 0 0 2 0 8
5 0 3 6 1 4 7 2 5 0 3 0 1 0 7 0 5 8 3 6 0 0 0 0 0 0 0 0 0 0 0 2 5 0 3 0 1 4 7 2 5 8 3 6 1 0 0 0 0 0 3 6 1 0 7 0 5 0 3 0 0 0 0 0 5 8 3 6 1 0 7
4 0 2 0 0 0 0 0 4 0 2 0 8 0 6 0 0 0 0 0 0 0 0 0 0 0 0 0 0 0 0 0 4 0 0 0 8 0 0 0 4 0 0 0 0 0 0 0 0 0 0 0 8 0 0 0 4 0 2 0 0 0 0 0 0 0 0 0 0 0 6
3 0 1 0 7 0 5 8 3 0 1 0 7 0 5 8 3 6 1 0 0 0 0 0 0 6 0 0 0 0 0 0 3 6 1 0 7 0 5 0 3 0 1 4 7 0 0 0 0 0 0 0 0 0 5 8 3 0 1 0 7 0 5 8 3 6 1 4 7 0 5
2 0 0 0 6 0 4 0 0 0 8 0 6 0 4 0 0 0 0 0 6 0 4 0 0 0 0 0 0 0 0 0 0 0 8 0 0 0 4 0 0 0 8 0 0 0 0 0 0 0 0 0 0 0 0 0 2 0 8 0 6 0 0 0 0 0 0 0 6 0 4
1 0 7 2 5 0 3 0 1 4 7 0 5 8 3 0 1 4 7 0 5 0 3 0 1 0 0 0 0 0 0 6 1 0 7 2 5 0 3 6 1 4 7 2 5 8 3 6 1 0 0 0 0 0 0 0 0 0 7 0 5 8 3 6 1 4 7 0 5 8 3
8 0 6 0 4 0 0 0 8 0 6 0 0 0 0 0 8 0 0 0 0 0 2 0 8 0 6 0 4 0 2 0 0 0 0 0 4 0 2 0 0 0 0 0 0 0 2 0 0 0 0 0 0 0 0 0 0 0 0 0 0 0 0 0 0 0 0 0 0 0 2
7 0 5 0 3 6 1 4 7 0 5 0 3 6 1 4 7 2 5 8 3 6 1 0 7 0 5 0 3 0 1 0 0 0 0 0 3 0 1 0 7 2 5 8 3 0 1 0 7 0 0 0 0 0 0 0 0 0 0 0 0 0 1 4 7 0 0 0 0 0 1
6 0 4 0 0 0 8 0 0 0 0 0 2 0 0 0 6 0 0 0 2 0 0 0 6 0 4 0 2 0 0 0 0 0 0 0 0 0 8 0 0 0 0 0 2 0 8 0 6 0 0 0 2 0 0 0 0 0 0 0 0 0 0 0 0 0 0 0 0 0 8
5 0 3 0 1 4 7 0 5 8 3 6 1 0 7 0 5 0 3 0 1 0 7 2 5 0 3 0 1 4 7 0 0 0 0 0 1 4 7 2 5 8 3 0 1 0 7 0 5 0 3 6 1 0 0 0 0 0 0 0 0 0 7 2 5 0 0 0 0 0 7
4 0 2 0 0 0 0 0 0 0 2 0 0 0 6 0 0 0 2 0 8 0 0 0 4 0 2 0 0 0 0 0 0 0 0 0 8 0 6 0 0 0 0 0 8 0 0 0 4 0 0 0 0 0 6 0 0 0 0 0 0 0 6 0 0 0 0 0 0 0 6
3 0 1 4 7 2 5 8 3 0 1 0 7 2 5 8 3 6 1 0 7 2 5 0 3 0 1 0 7 2 5 0 0 0 0 0 0 0 0 0 0 6 1 4 7 2 5 8 3 0 1 4 7 2 5 8 0 0 0 0 0 0 5 0 3 0 1 4 7 0 5
2 0 0 0 0 0 0 0 0 0 0 0 0 0 4 0 0 0 8 0 0 0 4 0 2 0 8 0 6 0 0 0 0 0 8 0 0 0 0 0 0 0 0 0 0 0 0 0 2 0 8 0 0 0 0 0 0 0 0 0 0 0 0 0 2 0 0 0 6 0 4
1 4 7 2 5 8 0 0 0 0 0 2 5 0 3 6 1 0 7 2 5 0 3 0 1 0 7 2 5 0 3 6 1 0 7 2 0 0 0 0 0 0 0 2 5 0 3 6 1 0 7 0 5 0 3 0 0 0 0 0 0 8 3 6 1 4 7 0 5 0 3
8 0 6 0 0 0 0 0 0 0 0 0 4 0 0 0 8 0 0 0 4 0 0 0 8 0 0 0 0 0 2 0 0 0 6 0 0 0 0 0 0 0 0 0 4 0 0 0 0 0 6 0 4 0 2 0 0 0 0 0 0 0 2 0 0 0 0 0 4 0 2
7 0 5 0 3 6 0 0 0 0 0 0 3 6 1 0 7 0 5 0 3 6 1 4 7 2 5 8 3 6 1 0 7 2 5 8 0 0 0 0 0 0 0 0 3 6 1 4 7 2 5 8 3 0 1 4 0 0 0 0 0 0 1 4 7 2 5 0 3 0 1
6 0 4 0 2 0 0 0 0 0 0 0 0 0 8 0 6 0 4 0 0 0 0 0 6 0 0 0 0 0 8 0 6 0 0 0 0 0 0 0 0 0 0 0 0 0 0 0 6 0 0 0 0 0 8 0 0 0 0 0 0 0 8 0 0 0 4 0 0 0 8
5 0 3 0 1 0 7 0 5 0 3 0 0 0 0 0 5 0 3 6 1 4 7 0 5 0 3 0 1 4 7 0 5 0 3 6 1 4 7 2 5 8 3 0 0 0 0 0 5 0 3 0 1 0 7 2 5 8 3 6 1 4 7 0 5 0 3 6 1 0 7
4 0 2 0 8 0 6 0 0 0 2 0 0 0 0 0 4 0 0 0 0 0 6 0 4 0 2 0 0 0 6 0 0 0 2 0 0 0 0 0 4 0 0 0 0 0 0 0 0 0 2 0 8 0 6 0 0 0 2 0 0 0 6 0 4 0 0 0 8 0 6
3 0 1 0 7 0 5 8 3 0 1 0 0 0 0 0 3 0 1 4 7 0 5 8 3 0 1 4 7 0 5 8 3 6 1 4 7 2 5 0 3 0 1 0 0 0 0 0 0 0 1 0 7 2 5 0 3 0 1 0 7 0 5 0 0 0 0 0 0 0 5
2 0 0 0 6 0 4 0 0 0 8 0 0 0 0 0 0 0 8 0 6 0 0 0 2 0 8 0 0 0 4 0 0 0 0 0 0 0 0 0 0 0 0 0 0 0 0 0 0 0 8 0 0 0 0 0 2 0 0 0 6 0 0 0 0 0 0 0 0 0 4
1 0 7 2 5 0 3 6 1 4 7 0 0 0 0 0 0 0 7 0 5 8 3 0 1 0 7 0 5 0 3 0 1 0 7 2 0 0 0 0 0 0 0 0 0 0 0 0 0 4 7 2 5 8 3 6 1 4 7 0 5 8 3 6 0 0 0 0 0 8 3
8 0 6 0 0 0 0 0 0 0 0 0 0 0 0 0 0 0 6 0 0 0 2 0 8 0 6 0 4 0 2 0 8 0 0 0 0 0 0 0 0 0 0 0 0 0 0 0 0 0 0 0 0 0 0 0 0 0 6 0 4 0 0 0 0 0 0 0 0 0 2
7 0 5 0 3 6 1 4 7 2 5 8 0 0 0 0 0 0 0 0 0 0 1 0 7 0 5 0 3 0 1 0 7 2 5 8 0 0 0 0 0 0 0 0 3 6 1 4 7 0 5 8 3 6 1 4 7 0 5 0 3 6 1 0 0 0 0 0 0 0 1
6 0 4 0 2 0 0 0 0 0 4 0 0 0 0 0 0 0 0 0 0 0 8 0 0 0 4 0 2 0 8 0 6 0 4 0 0 0 0 0 0 0 0 0 0 0 0 0 6 0 4 0 0 0 8 0 0 0 4 0 0 0 0 0 0 0 0 0 2 0 8
5 0 3 0 1 4 7 0 5 8 3 0 1 0 0 0 0 0 0 0 0 0 7 2 5 8 3 0 1 4 7 0 5 0 3 0 0 0 0 0 0 0 3 6 1 4 7 0 5 0 3 6 1 0 7 0 5 8 3 6 0 0 0 0 0 0 3 6 1 0 7
4 0 2 0 8 0 0 0 4 0 0 0 8 0 0 0 0 0 0 0 0 0 0 0 0 0 0 0 0 0 0 0 4 0 2 0 0 0 6 0 0 0 0 0 8 0 0 0 4 0 0 0 8 0 0 0 4 0 0 0 0 0 0 0 0 0 2 0 0 0 6
3 0 1 0 7 0 5 8 3 0 1 4 7 2 5 8 3 0 0 0 0 0 5 8 3 0 0 0 0 0 0 8 3 0 1 4 7 0 5 0 3 0 1 0 7 0 5 8 3 0 1 0 7 0 5 8 3 0 1 4 0 0 0 0 0 0 1 0 7 2 5
2 0 8 0 0 0 4 0 0 0 0 0 0 0 0 0 0 0 0 0 6 0 0 0 2 0 0 0 0 0 0 0 0 0 0 0 6 0 0 0 2 0 8 0 6 0 4 0 0 0 8 0 6 0 0 0 2 0 8 0 0 0 0 0 0 0 0 0 0 0 4
1 0 7 2 5 0 3 0 1 4 0 0 0 0 0 0 1 4 7 0 5 0 3 0 1 4 0 0 0 0 0 6 1 4 7 0 5 8 3 6 1 0 7 2 5 0 3 6 1 4 7 0 5 8 3 0 1 0 7 0 5 0 3 6 1 0 0 0 0 0 3
8 0 6 0 0 0 2 0 0 0 0 0 0 0 0 0 0 0 6 0 4 0 2 0 0 0 0 0 0 0 0 0 0 0 6 0 0 0 0 0 8 0 0 0 4 0 0 0 0 0 0 0 4 0 2 0 8 0 6 0 4 0 0 0 8 0 0 0 0 0 2
7 0 5 8 3 6 1 4 7 2 0 0 0 0 0 0 0 0 5 0 3 0 1 0 0 0 0 0 3 6 1 4 7 0 5 0 3 6 1 4 7 2 5 0 3 6 1 4 7 2 5 8 3 0 1 0 7 0 5 0 3 6 1 0 7 0 0 0 0 0 1
6 0 0 0 0 0 0 0 0 0 0 0 0 0 0 0 0 0 0 0 0 0 0 0 0 0 0 0 0 0 0 0 6 0 0 0 0 0 0 0 0 0 0 0 0 0 8 0 0 0 0 0 2 0 0 0 6 0 4 0 2 0 8 0 0 0 0 0 0 0 8
5 8 3 0 0 0 0 0 5 8 3 6 1 0 0 0 0 0 0 0 0 0 0 0 0 0 0 0 1 4 7 0 5 8 0 0 0 0 0 2 5 0 3 6 1 4 7 0 5 8 3 0 1 0 7 2 5 0 3 0 1 0 7 2 5 0 3 6 1 0 7
4 0 0 0 0 0 0 0 0 0 0 0 0 0 0 0 0 0 0 0 0 0 0 0 0 0 0 0 0 0 0 0 4 0 0 0 0 0 0 0 0 0 2 0 0 0 6 0 4 0 2 0 0 0 6 0 4 0 0 0 8 0 0 0 4 0 2 0 0 0 6
3 0 0 0 0 0 0 0 3 0 0 0 0 0 0 0 0 0 0 0 0 0 0 0 3 0 1 0 0 0 0 0 3 0 0 0 0 0 0 8 3 6 1 0 7 0 5 0 3 0 1 4 7 2 5 0 3 6 1 4 7 0 5 8 3 0 1 0 7 0 5
2 0 0 0 0 0 0 0 2 0 0 0 0 0 0 0 0 0 0 0 0 0 0 0 2 0 0 0 0 0 0 0 0 0 0 0 0 0 0 0 0 0 8 0 6 0 0 0 2 0 8 0 0 0 0 0 0 0 0 0 6 0 0 0 0 0 8 0 6 0 4
1 0 0 0 0 0 0 0 0 0 0 0 0 0 0 0 1 4 7 2 5 0 3 0 1 4 7 0 0 0 0 0 1 4 7 0 5 0 3 0 1 0 7 0 5 8 3 6 1 0 7 0 5 8 3 6 1 4 7 0 5 0 3 6 1 4 7 0 5 8 3
8 0 0 0 0 0 0 0 0 0 0 0 0 0 0 0 8 0 0 0 4 0 2 0 0 0 0 0 0 0 0 0 0 0 0 0 4 0 0 0 8 0 6 0 4 0 0 0 0 0 6 0 4 0 0 0 0 0 6 0 0 0 2 0 0 0 6 0 0 0 2
7 0 0 0 0 0 0 4 0 0 0 0 0 6 1 4 7 0 5 0 3 0 1 0 7 2 5 8 0 0 0 0 0 0 5 8 3 6 1 4 7 0 5 0 3 0 1 4 7 0 5 0 3 0 1 4 7 2 5 8 3 6 1 0 7 0 5 8 3 0 1
6 0 0 0 0 0 0 0 0 0 0 0 0 0 0 0 0 0 4 0 2 0 8 0 6 0 0 0 0 0 0 0 0 0 0 0 0 0 0 0 6 0 0 0 2 0 0 0 6 0 0 0 0 0 8 0 0 0 4 0 0 0 0 0 6 0 0 0 0 0 8
5 0 0 0 0 0 0 0 0 0 0 0 0 0 7 2 5 8 3 0 1 4 7 0 5 0 3 6 0 0 0 0 0 8 3 6 1 0 7 0 5 8 3 6 1 4 7 2 5 8 3 6 1 4 7 0 5 0 3 0 1 4 7 2 5 8 3 6 1 0 7
4 0 0 0 8 0 0 0 4 0 0 0 0 0 0 0 0 0 2 0 0 0 0 0 4 0 0 0 0 0 0 0 0 0 0 0 0 0 6 0 0 0 0 0 0 0 0 0 0 0 0 0 0 0 0 0 4 0 0 0 8 0 0 0 0 0 0 0 0 0 6
3 6 1 4 7 2 5 8 3 6 1 4 7 2 5 8 3 6 1 4 7 2 5 8 3 6 1 4 7 2 5 8 3 6 1 4 7 2 5 8 3 6 1 4 7 2 5 8 3 6 1 4 7 2 5 8 3 6 1 4 7 2 5 8 3 6 1 4 7 2 5
51.5 0.5 0.0
69.5 49.5
36
12.5 49.5 0
31.5 1.5 0
58.5 19.5 0
14.5 35.5 0
23.5 10.5 0
20.5 49.5 0
10.5 15.5 0
44.5 41.5 0
34.5 15.5 1
23.5 13.5 1
19.5 48.5 1
9.5 4.5 1
24.5 37.5 1
62.5 34.5 1
53.5 40.5 1
27.5 16.5 1
21.5 30.5 2
23.5 6.5 2
42.5 28.5 2
29.5 42.5 2
69.5 9.5 2
1.5 33.5 2
43.5 35.5 2
17.5 11.5 2
59.5 7.5 3
25.5 20.5 3
11.5 12.5 3
3.5 47.5 3
37.5 6.5 3
51.5 26.5 3
37.5 32.5 3
43.5 6.5 3
44.5 49.5 3
17.5 40.5 3
13.5 7.5 3
49.5 32.5 3
