55 55
4 7 2 5 8 3 6 1 4 7 2 5 8 3 6 1 4 7 2 5 8 3 0 0 0 0 0 5 8 3 6 1 4 7 2 5 8 3 6 1 4 7 2 5 8 3 6 1 4 7 2 5 8 3 6
3 0 1 0 0 0 0 0 0 0 0 0 0 0 0 0 0 0 0 0 0 0 0 0 0 0 0 0 0 0 0 0 0 0 1 0 0 0 0 0 0 0 1 0 0 0 0 0 0 0 0 0 7 0 5
2 0 8 3 6 1 4 7 2 5 8 3 6 0 4 0 2 5 8 3 6 1 0 0 0 0 0 3 6 0 4 7 2 5 8 0 6 0 4 7 2 5 8 0 6 1 4 0 2 5 8 0 6 0 4
1 0 0 0 0 0 0 0 1 0 0 0 5 0 3 0 1 0 0 0 5 0 0 0 0 0 0 0 5 0 3 0 0 0 0 0 5 0 0 0 0 0 0 0 5 0 3 0 0 0 7 0 0 0 3
8 0 0 0 0 0 2 0 8 0 6 0 4 0 2 0 8 0 6 0 4 0 0 0 0 0 0 0 4 7 2 0 8 3 6 1 4 7 2 5 8 3 6 1 4 0 2 5 8 0 6 1 4 0 2
7 0 0 0 0 0 1 0 0 0 5 0 3 0 1 0 7 0 5 0 0 0 1 0 7 0 5 0 3 0 0 0 7 0 0 0 0 0 0 0 7 0 0 0 0 0 0 0 0 0 5 0 0 0 1
6 0 0 0 0 0 8 3 6 1 4 0 2 0 8 0 6 0 4 0 2 5 8 0 6 0 4 0 2 0 8 3 6 1 4 7 2 0 8 0 6 0 0 0 0 0 0 0 0 0 4 0 2 5 8
5 0 0 0 0 0 0 0 0 0 0 0 1 0 7 0 5 0 3 0 1 0 0 0 5 0 3 0 0 0 0 0 0 0 0 0 0 0 7 0 0 0 0 0 0 0 0 0 0 0 0 0 1 0 7
4 0 0 0 0 0 0 0 4 7 2 5 8 3 6 0 4 0 2 5 8 0 6 1 4 7 2 5 8 0 6 1 4 7 2 0 0 0 0 0 4 7 0 0 0 0 0 0 0 0 2 5 8 0 6
3 0 0 0 0 0 0 0 0 0 0 0 0 0 0 0 3 0 1 0 0 0 5 0 0 0 0 0 7 0 5 0 0 0 0 0 0 0 0 0 0 0 0 0 0 0 0 0 0 0 0 0 0 0 5
2 5 0 0 0 0 0 7 2 5 8 3 6 1 4 7 2 0 8 0 6 1 4 0 2 5 8 0 6 1 4 0 0 0 0 0 0 0 0 0 2 0 8 3 6 0 0 0 0 0 8 3 6 0 4
1 0 0 0 0 0 0 0 0 0 0 0 0 0 3 0 0 0 0 0 0 0 0 0 0 0 7 0 0 0 0 0 0 0 0 0 0 0 0 0 1 0 0 0 5 0 3 0 0 0 7 0 0 0 3
8 0 6 1 4 0 2 5 8 3 6 0 4 7 2 0 8 3 6 1 0 0 0 0 0 0 0 0 0 0 0 5 0 0 0 0 0 0 0 0 8 3 6 0 4 7 2 0 8 0 6 0 4 7 2
7 0 5 0 3 0 1 0 7 0 0 0 3 0 0 0 7 0 0 0 0 0 0 0 0 0 0 0 0 0 0 0 0 0 0 0 0 0 0 0 0 0 5 0 0 0 1 0 7 0 5 0 0 0 1
6 0 4 0 2 0 8 0 6 0 4 7 2 0 8 3 6 1 4 0 0 0 0 0 0 1 0 0 0 0 0 3 0 0 0 0 0 5 8 3 6 0 4 7 2 0 8 3 6 0 4 7 2 0 8
5 0 3 0 1 0 7 0 0 0 0 0 1 0 7 0 0 0 3 0 0 0 0 0 0 0 0 0 0 0 0 0 5 0 3 0 0 0 7 0 5 0 3 0 1 0 7 0 0 0 0 0 0 0 7
4 0 2 0 8 0 6 1 4 7 2 5 8 0 6 0 4 0 2 0 8 3 6 1 4 0 0 0 0 0 0 0 4 0 2 5 0 0 0 0 0 0 2 0 8 0 6 0 0 0 0 0 0 0 6
3 0 0 0 7 0 0 0 0 0 1 0 0 0 5 0 3 0 0 0 7 0 0 0 3 0 1 0 0 0 5 0 0 0 1 0 0 0 0 0 0 0 0 0 7 0 0 0 0 0 0 0 0 0 5
2 0 8 3 6 1 4 7 2 0 8 0 6 1 4 0 2 5 8 3 6 0 4 0 2 0 8 0 6 1 4 7 2 0 8 0 0 0 0 0 0 5 8 3 6 1 4 7 0 0 0 0 0 1 4
1 0 7 0 0 0 0 0 0 0 7 0 0 0 3 0 0 0 7 0 0 0 3 0 1 0 7 0 0 0 0 0 1 0 0 0 0 0 0 0 0 0 7 0 0 0 0 0 0 0 0 0 0 0 3
8 0 6 0 4 7 2 5 8 0 6 1 4 0 2 0 8 0 6 0 4 7 2 0 8 0 6 1 4 0 2 0 8 0 0 0 0 0 0 0 0 0 6 0 4 0 0 0 0 0 0 0 4 0 2
7 0 5 0 0 0 0 0 7 0 0 0 3 0 1 0 0 0 0 0 0 0 1 0 7 0 0 0 3 0 1 0 7 0 0 0 0 0 0 0 7 0 0 0 0 0 0 0 0 0 0 0 3 0 1
6 0 4 7 0 0 0 0 0 1 4 7 2 0 8 0 0 0 0 0 0 0 8 0 6 0 4 7 2 0 8 3 6 0 0 0 0 0 0 0 6 1 4 7 0 0 0 0 0 0 0 0 2 5 8
5 0 0 0 0 0 0 0 0 0 0 0 0 0 7 0 0 0 0 0 0 0 7 0 5 0 3 0 0 0 7 0 0 0 0 0 0 0 0 0 5 0 0 0 0 0 0 0 0 0 0 0 0 0 7
4 7 2 5 0 0 0 0 0 0 2 5 8 3 6 0 0 0 0 0 0 3 6 0 4 7 2 0 8 3 6 0 4 0 0 0 0 0 6 0 4 0 2 5 0 0 0 0 0 0 0 5 8 0 6
3 0 0 0 0 0 0 0 0 0 1 0 0 0 5 0 0 0 0 0 0 0 5 0 0 0 1 0 0 0 0 0 3 0 0 0 0 0 0 0 3 0 0 0 0 0 0 0 0 0 0 0 0 0 0
2 0 8 3 0 0 0 0 0 5 8 0 6 0 4 0 2 0 8 0 0 0 0 0 2 0 8 3 6 1 4 7 2 0 0 0 0 0 4 7 2 5 8 0 6 0 0 0 0 0 0 0 0 0 0
1 0 0 0 5 0 0 0 1 0 0 0 5 0 0 0 1 0 7 0 0 0 0 0 1 0 0 0 0 0 0 0 1 0 0 0 0 0 0 0 0 0 7 0 5 0 0 0 0 0 0 0 0 0 0
8 3 6 0 4 0 2 5 8 3 6 1 4 0 2 5 8 3 6 0 0 0 0 0 0 0 0 0 0 7 2 0 8 0 0 0 0 0 2 5 8 0 6 1 4 0 0 0 0 0 0 0 0 0 0
7 0 0 0 3 0 0 0 0 0 0 0 3 0 0 0 7 0 0 0 0 0 0 0 0 0 0 0 0 0 0 0 7 0 0 0 0 0 0 0 7 0 0 0 3 0 0 0 0 0 0 0 0 0 0
6 0 4 7 2 5 8 3 6 1 4 0 2 5 8 0 6 0 4 0 0 0 0 0 0 0 0 0 0 5 8 3 6 0 4 0 2 5 8 3 6 1 4 0 2 0 8 3 6 0 4 7 2 5 8
5 0 0 0 1 0 0 0 0 0 3 0 0 0 7 0 0 0 3 0 1 0 0 0 0 0 0 0 0 0 7 0 0 0 3 0 0 0 7 0 0 0 0 0 1 0 0 0 5 0 0 0 0 0 7
4 7 2 0 8 0 6 0 0 0 0 0 8 0 6 1 4 7 2 5 8 0 6 1 0 0 0 0 0 3 6 0 4 7 2 5 8 0 6 0 4 7 2 5 8 3 6 1 4 7 2 5 8 0 6
0 0 0 0 0 0 5 0 0 0 0 0 0 0 0 0 0 0 1 0 0 0 5 0 0 0 1 0 7 0 0 0 3 0 0 0 7 0 0 0 3 0 0 0 0 0 0 0 0 0 0 0 0 0 5
0 0 0 0 0 0 4 0 0 0 0 0 0 0 0 0 2 0 8 0 6 1 4 7 2 5 8 0 6 0 4 7 2 5 8 0 6 1 4 7 2 5 8 3 6 0 4 7 2 0 0 0 0 0 4
0 0 0 0 0 0 3 0 0 0 0 0 0 0 0 0 1 0 0 0 5 0 0 0 0 0 7 0 5 0 0 0 0 0 7 0 0 0 0 0 0 0 0 0 0 0 3 0 0 0 0 0 0 0 3
0 0 0 0 0 0 2 0 0 0 0 0 0 0 0 0 8 3 6 1 4 0 2 5 8 0 6 0 4 7 2 5 8 0 6 1 4 0 2 5 8 0 6 1 4 7 2 0 8 0 0 0 0 0 2
0 0 0 0 0 0 0 0 7 0 5 0 0 0 0 0 0 0 0 0 3 0 1 0 0 0 0 0 3 0 0 0 7 0 0 0 3 0 0 0 0 0 0 0 0 0 0 0 7 0 0 0 0 0 1
6 1 4 0 2 5 8 3 6 0 4 0 2 5 8 3 6 1 4 0 2 0 8 3 6 1 4 0 2 5 8 0 6 1 4 0 2 5 8 0 0 0 0 0 2 5 8 3 6 0 4 7 2 0 8
5 0 0 0 0 0 0 0 0 0 3 0 0 0 7 0 0 0 0 0 1 0 0 0 5 0 3 0 0 0 0 0 5 0 3 0 1 0 0 0 0 0 0 0 0 0 0 0 5 0 0 0 1 0 7
4 0 2 5 8 3 6 1 4 7 2 5 8 0 6 0 4 7 2 5 8 0 6 0 4 0 2 5 8 3 6 0 4 0 2 0 8 0 6 0 0 0 0 0 8 3 6 0 4 7 2 0 8 0 6
3 0 1 0 0 0 0 0 0 0 0 0 0 0 0 0 3 0 0 0 0 0 5 0 3 0 0 0 0 0 0 0 0 0 1 0 7 0 0 0 0 0 0 0 7 0 0 0 3 0 0 0 7 0 5
2 0 8 0 6 1 4 7 2 0 0 0 0 0 0 7 2 0 8 3 6 1 4 0 2 5 8 0 6 1 4 7 2 5 8 0 6 0 4 7 0 0 0 0 0 0 4 7 2 0 8 0 6 0 4
1 0 0 0 5 0 0 0 1 0 0 0 0 0 0 0 1 0 0 0 0 0 3 0 0 0 7 0 0 0 0 0 0 0 0 0 5 0 3 0 0 0 0 0 0 0 0 0 1 0 7 0 5 0 3
8 0 6 1 4 0 2 0 8 3 0 0 0 0 0 5 8 3 6 1 4 0 2 5 8 0 6 0 0 0 0 0 0 3 6 1 4 0 2 0 0 0 0 0 0 0 2 0 8 0 6 1 4 0 2
7 0 5 0 0 0 1 0 0 0 0 0 0 0 0 0 0 0 0 0 0 0 0 0 7 0 0 0 0 0 0 0 0 0 0 0 3 0 1 0 0 0 0 0 0 0 1 0 7 0 0 0 0 0 1
6 0 4 0 2 5 8 3 6 0 0 0 0 0 8 3 6 1 4 0 0 0 0 0 6 1 4 0 0 0 0 0 0 1 4 0 2 5 8 0 0 0 0 0 0 0 8 0 6 1 4 7 2 5 8
5 0 0 0 1 0 0 0 0 0 0 0 0 0 0 0 5 0 3 0 0 0 0 0 5 0 0 0 0 0 0 0 0 0 3 0 1 0 0 0 0 0 0 0 1 0 7 0 0 0 0 0 0 0 7
4 7 2 5 8 0 6 0 0 0 0 0 0 0 6 0 4 0 2 0 0 0 0 0 4 0 2 5 0 0 0 0 0 0 2 0 8 0 6 0 0 0 0 0 8 3 6 1 4 7 2 5 8 0 6
3 0 0 0 7 0 5 0 0 0 0 0 0 0 5 0 0 0 1 0 0 0 0 0 3 0 0 0 7 0 0 0 3 0 0 0 0 0 0 0 0 0 0 0 0 0 0 0 0 0 1 0 0 0 5
2 0 8 0 6 0 4 0 0 0 0 0 0 0 4 7 2 0 8 0 6 0 4 0 2 5 8 0 6 0 4 0 2 0 0 0 0 0 0 0 0 0 0 0 6 1 4 7 2 0 8 0 6 1 4
1 0 7 0 5 0 0 0 0 0 0 0 0 0 3 0 1 0 0 0 5 0 3 0 0 0 0 0 5 0 3 0 0 0 0 0 0 0 0 0 1 0 0 0 5 0 0 0 0 0 7 0 0 0 3
8 0 6 1 4 7 2 0 0 0 0 0 4 7 2 0 8 3 6 1 4 0 2 5 8 3 6 1 4 0 2 5 8 3 0 0 0 0 0 5 8 0 6 1 4 0 2 5 8 3 6 1 4 0 2
7 0 0 0 0 0 0 0 0 0 0 0 0 0 0 0 0 0 0 0 0 0 0 0 0 0 0 0 0 0 1 0 0 0 0 0 0 0 0 0 0 0 0 0 0 0 0 0 0 0 0 0 0 0 1
6 1 4 7 2 5 8 3 6 1 4 7 2 5 8 3 6 1 4 7 2 5 8 3 6 1 4 7 2 5 8 3 6 1 4 7 2 5 8 3 6 1 4 7 2 5 8 3 6 1 4 7 2 5 8
22.5 0.5 0.0
53.5 53.5
30
49.5 7.5 0
14.5 43.5 0
34.5 33.5 0
43.5 41.5 0
9.5 14.5 0
47.5 17.5 0
28.5 19.5 0
15.5 40.5 1
33.5 24.5 1
31.5 47.5 1
13.5 44.5 1
15.5 48.5 1
41.5 53.5 1
43.5 50.5 1
9.5 50.5 2
53.5 42.5 2
17.5 48.5 2
17.5 7.5 2
37.5 42.5 2
10.5 11.5 2
15.5 21.5 2
36.5 18.5 3
30.5 5.5 3
45.5 46.5 3
50.5 20.5 3
42.5 23.5 3
1.5 37.5 3
47.5 10.5 3
19.5 30.5 3
39.5 24.5 3
